11 14
7 9
0 0 0 0 0 0 0 0 0 0 0 0 0 0 
0 0 0 0 0 0 0 0 0 0 0 0 0 0 
0 0 0 0 0 0 0 0 0 0 0 0 0 0
0 1 1 1 1 1 0 0 1 1 1 0 0 0 
0 1 0 0 0 1 0 1 0 0 0 1 1 0 
0 1 0 0 1 0 0 1 0 0 0 0 0 0 
0 1 1 1 1 1 1 1 0 1 1 0 0 0 
0 1 0 0 1 0 0 1 0 4 1 1 1 0
0 1 0 0 0 1 0 1 0 0 0 0 1 0 
0 1 0 0 0 1 0 1 1 1 1 1 1 0 
0 0 0 0 0 0 0 0 0 0 0 0 0 0 
